レント・ファイナ	Rentt Faina
ファイナ	Faina
レント	Rentt
れんと	Rentt
リナ・ルパージュ	Rina Rupaage
リナ	Rina
ルパージュ	Rupaage
シェイラ・イバルス	Sheila Ibarss
イバルス	Ibarss
シェイラ	Sheila
ロレーヌ・ヴィヴィエ	Lorraine Vivie
ヴィヴィエ	Vivie
ロレーヌ	Lorraine
ろれーぬ	Lorraine
ロリス・カリエッロ	Loris Cariello
カリエッロ	Cariello
ロリス	Loris
イドレス・ローグ	Idoles Rogue
りな・ろーぐ	Rina Rogue
ローグ	Rogue
イドレス	Idoles